1111111111111111
1000000000C00P11
1011111111111111
1010C00000000011
1010111111111011
101010C000C01011
1010101111101011
101C1C1CCC101011
10101C1CEC101011
1010101CCC101011
1010101110101011
101010C0C0101C11
1010111111101011
10100000C0001011
1011111111111011
100C000000000011
1111111111111111